111111111111111111111111111111111111111111111111111111111111111
1.............................................................1
1.............................................................1
1.............................................................1
1.............................................................1
1.............................................................1
1..................................R..........................1
1.............................................................1
1.............................................................1
1.............................................................1
1.............................................................1
1......................S......................................1
1.............................................................1
1.............................................................1
1.............................................................1
1.............................................................1
1.............................................................1
1.............................................................1
1.............................................................1
1...............P.............................................1
1.............................................................1
1.............................................................1
1.............................................................1
1.............................................................1
1.............................................................1
1.............................................................1
1.............................................................1
1.............................................................1
1.............................................................1
...........................S...................................
...............................................................
...............................................................
...............................................................
...............................................................
...............................................................
...............................................................
...............................................................
...............................................................
...............................................................
...............................................................
...............................................................
111111111111111111111111111111111111111111111111111111111111111
111111111111111111111111111111111111111111111111111111111111111
1.............................................................1
1.............................................................1
1.............................................................1
1.............................................................1
111111111111111111111111111111111111111111111111111111111111111